#################
#.#.....##......#
#.#...#......8..#
#.###.##........#
#...#.#.........#
###.#.#.........#
#...#.#.........#
#.###.#.........#
#.....#.........#
#################
